1111111111111111111111111111111111111111
1000000000000000000000000000000000000001
1000000000000000000000000000000000000001
1000000000001110000000000000000000000001
1000000000001110000000000000000000000001
1000000000001110000000000000000000000001
1000000000000000000000000000000000000001
1000000000000000000000000000000000000001
1000000000000000000000000000000000000001
1000000000000000000000000000000000000001
1000000000000000000000000000000000000001
1000001111000000000000000000000000000001
1000001111000000000000000000000000000001
1000000000000000000000000000000000000001
1000000000000000000000000000000000000001
1000000000000000000000000000000000000001
1000000000000000000000000000000000000001
1000000000000000000000000000000000000001
1000000000000000000000000000000000000001
1000000000000000000000000000100000000001
1000000000000000000000000000100000000001
1000000000000000000000000000100000000001
1000000000000000000000000000100000000001
1000000000000000000000000000100000000001
1000000000000000000000000000000000000001
1000000000000000000000000000000000000001
1000011100000000000000000000000000000001
1000000100000000000000000000000000000001
1000000000000000000000000000000000000001
1111111111111111111111111111111111111111